0000000000
0111001110
0001111000
0111001110
0000000000