00000000000
01111111110
01000000010
01011111110
01010000000
01010111110
01010100000
01010101110
01010101000
01111111110
00000000000